 *     * *           * *     *       * *   *             * * * *
 ***** * *** * * * *** * *********** * *** ***** ********* * * *
 * *   *   * * * *         * * *             *         *       *
 * * ***** ***** * *** * *** * * *********** * ***** *** * *** *
 * * *     *   * * *   *   * *   *   * * * * *   *   * * * * * *
 * * *** *** *** ******* * * *** * * * * * ********* * ***** * *
 *     *     * * *   *   *     *   *         * * * *       * * *
 ***** * * *** * * * * ********* * *** *** * * * * * * * * * * *
 *     * * *     * *       *   * * *   *   * *   *   * * * *   *
 ***** *** * *** *********** * * *** * *** * *** ***** * *** ***
   *   *   *   *   * *   * * *     * *   * *     *   * *   *   *
** * *** ***** * *** *** * ******* * *** ********* *** *** * * *
 *         *   *   *     * * *     * *   *             *     * *
 * ***** * *** *** * * *** * *** * *** *** *** ********* * * * *
       * *       *   *           *   *       *       *   * * * *
******************************************************** *******
   *     *         *       *     *         *           * * * * *
 * * *** *** * * *** ***** ***** * * * * *** ***** ***** * * * *
 * *   * * * * *     *     *       * * *       * *     *       *
 * * *** * *********** *** * * * ***** ********* * ***** *** ***
 *     *   * *   *   * *     * * * *         *   *         * * *
** ********* * * * ***** ******* * ******* *** * ***** ******* *
 * *           *           *       * *   * * * *     *   * *   *
 * ***** * *********** ********* *** *** * * * *** * *** * *** *
 *   *   * * *   *     *         * *   * * *   *   * *   *   * *
 * ******* * *** * *** ***** ***** * *** * * *********** * * * *
           *   * *   * * *       *     *     *   *   *     *   *
 ********* *** * *** *** * * * * * *** *** *** *** *** *** *** *
   *   *       *     *   * * * *   *   * *       *     *     * *
**** *** * * *** * * * * * *** ***** *** * *** * * * ***** * * *
         * *   * * *   * * *     *       *   * * * * *     * * *
************ ***************************************************
   *       *       * *   *     *   * *         *     * *   * * *
 * *** *** *** * *** * * * *** * *** ***** * * *** *** * *** * *
 * * * * * * * *       * * *   * * *   *   * * *   *   *       *
** * * * * * * *** * *** * ***** * * * ***** *** ***** * *** ***
       *   * * * * *   * * *   *     * *             *     *   *
** ***** * * * * * * *** * * * * * *********** ***** ********* *
     *   *     *   * *       * * *         * *   * * *   *   * *
 ******* * * ********* *** * * * * * ******* * *** * * ***** * *
 *     * * * * *       * * * * * * *   *         *   *         *
 * *** ***** * * *** *** ***** *** *** * *** *********** *** * *
 * * *   *     * * * * *   *         *   * *     * *     *   * *
**** *** ***** * * *** *** * * *** ******* ***** * *** *** * * *
 *             * *           * *   *   * *             * * * * *
 * *** *** *********** ***** *** *** *** *** ********* * * *****
   *     * *             *   *             *       *     *     *
 ***************************************************************
   *   *   *       * *         *   *   * * *     * *           *
** * * * ***** ***** *** ******* * * * * * * *** * *** * * * * *
     * *           * *     *     * * *     * *       * * * * * *
 ***** *** * ******* * * ***** * ******* ***** ***** * *** *****
   * * *   *   *       *       * * *     *         *     *     *
 * * *** *** ********* * ******* * * *** * * *** * * ***** *****
 *     *   *     * * * *       * *   *     * *   * *     *     *
** *** *** ******* * ***** *** * ******* ******* *** ***** *** *
 * * *   *     *           * * * * * * * * *       * *     *   *
 * * * *** ***** * ***** *** *** * * * * * *** *** ******* *** *
   *       *   * *   * *   *     *     *     * *     * * * *   *
**** *** ***** * *** * * ***** * *** *** *** * * ***** * * *** *
 * * *       *   *     *     * *           * * *   *   *   *   *
 * *** ***** * * ***** * *** *** ********* *** *** *** * * * ***
         *     *   *   *   * *     *         * *       * * *   *
**************************************************************  
